20, 320 
1, 0
19, 0 
X0XX00XXXX0000000000
00XXX0XXXX0XXXXXXXXX
00XXX0XXXX0XXXXXXXXX
00XXX0XXXX0XX0000000
000000XXXX0XX0XXXXXX
X0XX00000X0XX0XXXXXX
X0XX0XXX000000XXXXXX
X0XX00000X0XX0XXXXXX
X0XX0XXX000000XXXXXX
X0XX00XXXX0000000000
X0XX00XXXX0000000000
00XXX0XXXX0XXXXXXXXX
00XXX0XXXX0XXXXXXXXX
00XXX0XXXX0XX0000000
000000XXXX0XX0XXXXXX
X0XX00000X0XX0XXXXXX
X0XX0XXX000000XXXXXX
X0XX00000X0XX0XXXXXX
X0XX0XXX000000XXXXXX
X0XX00XXXX0000000000
X0XX00XXXX0000000000
00XXX0XXXX0XXXXXXXXX
00XXX0XXXX0XXXXXXXXX
00XXX0XXXX0XX0000000
000000XXXX0XX0XXXXXX
X0XX00000X0XX0XXXXXX
X0XX0XXX000000XXXXXX
X0XX00000X0XX0XXXXXX
X0XX0XXX000000XXXXXX
X0XX00XXXX0000000000
X0XX00XXXX0000000000
00XXX0XXXX0XXXXXXXXX
00XXX0XXXX0XXXXXXXXX
00XXX0XXXX0XX0000000
000000XXXX0XX0XXXXXX
X0XX00000X0XX0XXXXXX
X0XX0XXX000000XXXXXX
X0XX00000X0XX0XXXXXX
X0XX0XXX000000XXXXXX
X0XX00XXXX0000000000
X0XX00XXXX0000000000
00XXX0XXXX0XXXXXXXXX
00XXX0XXXX0XXXXXXXXX
00XXX0XXXX0XX0000000
000000XXXX0XX0XXXXXX
X0XX00000X0XX0XXXXXX
X0XX0XXX000000XXXXXX
X0XX00000X0XX0XXXXXX
X0XX0XXX000000XXXXXX
X0XX00XXXX0000000000
X0XX00XXXX0000000000
00XXX0XXXX0XXXXXXXXX
00XXX0XXXX0XXXXXXXXX
00XXX0XXXX0XX0000000
000000XXXX0XX0XXXXXX
X0XX00000X0XX0XXXXXX
X0XX0XXX000000XXXXXX
X0XX00000X0XX0XXXXXX
X0XX0XXX000000XXXXXX
X0XX00XXXX0000000000
X0XX00XXXX0000000000
00XXX0XXXX0XXXXXXXXX
00XXX0XXXX0XXXXXXXXX
00XXX0XXXX0XX0000000
000000XXXX0XX0XXXXXX
X0XX00000X0XX0XXXXXX
X0XX0XXX000000XXXXXX
X0XX00000X0XX0XXXXXX
X0XX0XXX000000XXXXXX
X0XX00XXXX0000000000
X0XX00XXXX0000000000
00XXX0XXXX0XXXXXXXXX
00XXX0XXXX0XXXXXXXXX
00XXX0XXXX0XX0000000
000000XXXX0XX0XXXXXX
X0XX00000X0XX0XXXXXX
X0XX0XXX000000XXXXXX
X0XX00000X0XX0XXXXXX
X0XX0XXX000000XXXXXX
X0XX00XXXX0000000000
X0XX00XXXX0000000000
00XXX0XXXX0XXXXXXXXX
00XXX0XXXX0XXXXXXXXX
00XXX0XXXX0XX0000000
000000XXXX0XX0XXXXXX
X0XX00000X0XX0XXXXXX
X0XX0XXX000000XXXXXX
X0XX00000X0XX0XXXXXX
X0XX0XXX000000XXXXXX
X0XX00XXXX0000000000
X0XX00XXXX0000000000
00XXX0XXXX0XXXXXXXXX
00XXX0XXXX0XXXXXXXXX
00XXX0XXXX0XX0000000
000000XXXX0XX0XXXXXX
X0XX00000X0XX0XXXXXX
X0XX0XXX000000XXXXXX
X0XX00000X0XX0XXXXXX
X0XX0XXX000000XXXXXX
X0XX00XXXX0000000000
X0XX00XXXX0000000000
00XXX0XXXX0XXXXXXXXX
00XXX0XXXX0XXXXXXXXX
00XXX0XXXX0XX0000000
000000XXXX0XX0XXXXXX
X0XX00000X0XX0XXXXXX
X0XX0XXX000000XXXXXX
X0XX00000X0XX0XXXXXX
X0XX0XXX000000XXXXXX
X0XX00XXXX0000000000
X0XX00XXXX0000000000
00XXX0XXXX0XXXXXXXXX
00XXX0XXXX0XXXXXXXXX
00XXX0XXXX0XX0000000
000000XXXX0XX0XXXXXX
X0XX00000X0XX0XXXXXX
X0XX0XXX000000XXXXXX
X0XX00000X0XX0XXXXXX
X0XX0XXX000000XXXXXX
X0XX00XXXX0000000000
X0XX00XXXX0000000000
00XXX0XXXX0XXXXXXXXX
00XXX0XXXX0XXXXXXXXX
00XXX0XXXX0XX0000000
000000XXXX0XX0XXXXXX
X0XX00000X0XX0XXXXXX
X0XX0XXX000000XXXXXX
X0XX00000X0XX0XXXXXX
X0XX0XXX000000XXXXXX
X0XX00XXXX0000000000
X0XX00XXXX0000000000
00XXX0XXXX0XXXXXXXXX
00XXX0XXXX0XXXXXXXXX
00XXX0XXXX0XX0000000
000000XXXX0XX0XXXXXX
X0XX00000X0XX0XXXXXX
X0XX0XXX000000XXXXXX
X0XX00000X0XX0XXXXXX
X0XX0XXX000000XXXXXX
X0XX00XXXX0000000000
X0XX00XXXX0000000000
00XXX0XXXX0XXXXXXXXX
00XXX0XXXX0XXXXXXXXX
00XXX0XXXX0XX0000000
000000XXXX0XX0XXXXXX
X0XX00000X0XX0XXXXXX
X0XX0XXX000000XXXXXX
X0XX00000X0XX0XXXXXX
X0XX0XXX000000XXXXXX
X0XX00XXXX0000000000
X0XX00XXXX0000000000
00XXX0XXXX0XXXXXXXXX
00XXX0XXXX0XXXXXXXXX
00XXX0XXXX0XX0000000
000000XXXX0XX0XXXXXX
X0XX00000X0XX0XXXXXX
X0XX0XXX000000XXXXXX
X0XX00000X0XX0XXXXXX
X0XX0XXX000000XXXXXX
X0XX00XXXX0000000000
X0XX00XXXX0000000000
00XXX0XXXX0XXXXXXXXX
00XXX0XXXX0XXXXXXXXX
00XXX0XXXX0XX0000000
000000XXXX0XX0XXXXXX
X0XX00000X0XX0XXXXXX
X0XX0XXX000000XXXXXX
X0XX00000X0XX0XXXXXX
X0XX0XXX000000XXXXXX
X0XX00XXXX0000000000
X0XX00XXXX0000000000
00XXX0XXXX0XXXXXXXXX
00XXX0XXXX0XXXXXXXXX
00XXX0XXXX0XX0000000
000000XXXX0XX0XXXXXX
X0XX00000X0XX0XXXXXX
X0XX0XXX000000XXXXXX
X0XX00000X0XX0XXXXXX
X0XX0XXX000000XXXXXX
X0XX00XXXX0000000000
X0XX00XXXX0000000000
00XXX0XXXX0XXXXXXXXX
00XXX0XXXX0XXXXXXXXX
00XXX0XXXX0XX0000000
000000XXXX0XX0XXXXXX
X0XX00000X0XX0XXXXXX
X0XX0XXX000000XXXXXX
X0XX00000X0XX0XXXXXX
X0XX0XXX000000XXXXXX
X0XX00XXXX0000000000
X0XX00XXXX0000000000
00XXX0XXXX0XXXXXXXXX
00XXX0XXXX0XXXXXXXXX
00XXX0XXXX0XX0000000
000000XXXX0XX0XXXXXX
X0XX00000X0XX0XXXXXX
X0XX0XXX000000XXXXXX
X0XX00000X0XX0XXXXXX
X0XX0XXX000000XXXXXX
X0XX00XXXX0000000000
X0XX00XXXX0000000000
00XXX0XXXX0XXXXXXXXX
00XXX0XXXX0XXXXXXXXX
00XXX0XXXX0XX0000000
000000XXXX0XX0XXXXXX
X0XX00000X0XX0XXXXXX
X0XX0XXX000000XXXXXX
X0XX00000X0XX0XXXXXX
X0XX0XXX000000XXXXXX
X0XX00XXXX0000000000
X0XX00XXXX0000000000
00XXX0XXXX0XXXXXXXXX
00XXX0XXXX0XXXXXXXXX
00XXX0XXXX0XX0000000
000000XXXX0XX0XXXXXX
X0XX00000X0XX0XXXXXX
X0XX0XXX000000XXXXXX
X0XX00000X0XX0XXXXXX
X0XX0XXX000000XXXXXX
X0XX00XXXX0000000000
X0XX00XXXX0000000000
00XXX0XXXX0XXXXXXXXX
00XXX0XXXX0XXXXXXXXX
00XXX0XXXX0XX0000000
000000XXXX0XX0XXXXXX
X0XX00000X0XX0XXXXXX
X0XX0XXX000000XXXXXX
X0XX00000X0XX0XXXXXX
X0XX0XXX000000XXXXXX
X0XX00XXXX0000000000
X0XX00XXXX0000000000
00XXX0XXXX0XXXXXXXXX
00XXX0XXXX0XXXXXXXXX
00XXX0XXXX0XX0000000
000000XXXX0XX0XXXXXX
X0XX00000X0XX0XXXXXX
X0XX0XXX000000XXXXXX
X0XX00000X0XX0XXXXXX
X0XX0XXX000000XXXXXX
X0XX00XXXX0000000000
X0XX00XXXX0000000000
00XXX0XXXX0XXXXXXXXX
00XXX0XXXX0XXXXXXXXX
00XXX0XXXX0XX0000000
000000XXXX0XX0XXXXXX
X0XX00000X0XX0XXXXXX
X0XX0XXX000000XXXXXX
X0XX00000X0XX0XXXXXX
X0XX0XXX000000XXXXXX
X0XX00XXXX0000000000
X0XX00XXXX0000000000
00XXX0XXXX0XXXXXXXXX
00XXX0XXXX0XXXXXXXXX
00XXX0XXXX0XX0000000
000000XXXX0XX0XXXXXX
X0XX00000X0XX0XXXXXX
X0XX0XXX000000XXXXXX
X0XX00000X0XX0XXXXXX
X0XX0XXX000000XXXXXX
X0XX00XXXX0000000000
X0XX00XXXX0000000000
00XXX0XXXX0XXXXXXXXX
00XXX0XXXX0XXXXXXXXX
00XXX0XXXX0XX0000000
000000XXXX0XX0XXXXXX
X0XX00000X0XX0XXXXXX
X0XX0XXX000000XXXXXX
X0XX00000X0XX0XXXXXX
X0XX0XXX000000XXXXXX
X0XX00XXXX0000000000
X0XX00XXXX0000000000
00XXX0XXXX0XXXXXXXXX
00XXX0XXXX0XXXXXXXXX
00XXX0XXXX0XX0000000
000000XXXX0XX0XXXXXX
X0XX00000X0XX0XXXXXX
X0XX0XXX000000XXXXXX
X0XX00000X0XX0XXXXXX
X0XX0XXX000000XXXXXX
X0XX00XXXX0000000000
X0XX00XXXX0000000000
00XXX0XXXX0XXXXXXXXX
00XXX0XXXX0XXXXXXXXX
00XXX0XXXX0XX0000000
000000XXXX0XX0XXXXXX
X0XX00000X0XX0XXXXXX
X0XX0XXX000000XXXXXX
X0XX00000X0XX0XXXXXX
X0XX0XXX000000XXXXXX
X0XX00XXXX0000000000
X0XX00XXXX0000000000
00XXX0XXXX0XXXXXXXXX
00XXX0XXXX0XXXXXXXXX
00XXX0XXXX0XX0000000
000000XXXX0XX0XXXXXX
X0XX00000X0XX0XXXXXX
X0XX0XXX000000XXXXXX
X0XX00000X0XX0XXXXXX
X0XX0XXX000000XXXXXX
X0XX00XXXX0000000000
X0XX00XXXX0000000000
00XXX0XXXX0XXXXXXXXX
00XXX0XXXX0XXXXXXXXX
00XXX0XXXX0XX0000000
000000XXXX0XX0XXXXXX
X0XX00000X0XX0XXXXXX
X0XX0XXX000000XXXXXX
X0XX00000X0XX0XXXXXX
X0XX0XXX000000XXXXXX
X0XX00XXXX0000000000
X0XX00XXXX0000000000
00XXX0XXXX0XXXXXXXXX
00XXX0XXXX0XXXXXXXXX
00XXX0XXXX0XX0000000
000000XXXX0XX0XXXXXX
X0XX00000X0XX0XXXXXX
X0XX0XXX000000XXXXXX
X0XX00000X0XX0XXXXXX
X0XX0XXX000000XXXXXX
X0XX00XXXX0000000000
